醮	jnyh
铽	tejx
眯	miom
会	kkrs
憧	isxl
爝	jthc
硬	ykug
具	juqb
揄	yufd
骞	qmbm
诽	fwyf
杭	hhmj
旱	hjog
袒	tjpd
尚	uhxk
婴	ykkn
俯	furc
蛋	djvi
效	xnww
疹	vfbp
犇	bfnn
绌	iusi
漠	modd
颛	vrer
捡	jmfa
忙	mhxw
有	yzuo
磨	mogu
灰	hvuh
怙	huxk
珅	ufwu
捕	buff
系	xipx
客	kebk
资	zidr
悟	wuxk
占	vjlk
股	guoy
棺	grmk
击	jiak
殒	yydr
筵	yjvz
系	jipx
残	cjdj
洁	jpdk
彤	tsdp
狰	vgql
缔	disj
抑	yife
拾	uifk
暑	uuoo
汋	vodu
豁	hobk
慎	ufxb
考	kclv
仿	fhrf
骥	jimb
帝	diwj
箢	yrvv
缓	hrsy
竖	uull
鸨	bcbn
湟	hldw
嵇	jihe
淼	mnuu
胧	lsol
杳	ycmo
忌	jijx
隍	hlew
眩	xroy
衙	yaii
锰	mgjm
囹	lkks
牒	dppm
跹	xmzz
嗬	hekk
簟	dmvu
鸾	lrwn
检	jmma
消	xndo
蓍	uico
酴	tuyh
秋	qqhh
住	vurv
琚	juwk
谠	dhye
榻	tamx
哩	likl
淦	gjdj
垯	datz
睽	kvot
肄	yiby
吸	xikj
盗	dcdm
聿	yuvl
铋	bijb
秧	yhhy
轻	qkig
夫	fuan
铲	ijji
肇	vchy
拍	pdfb
谏	jmyj
近	jbzj
茌	iicu
纭	yyss
刳	kudd
队	dver
埠	butu
箓	luvu
半	bjdl
娄	lzmn
独	duqi
案	anbm
线	xmsj
炕	khhj
蚶	hjig
羞	xqyi
放	fhfw
憬	jkxx
诹	zzyy
允	yyse
邯	hjge
篆	vrvu
樟	vhmu
卓	volu
阁	gemk
颗	kegr
缸	ghfg
钝	dyjt
撑	igfu
锄	iujl
墟	xuty
阀	famg
豪	hcwu
蚀	uiui
辩	bmlu
莹	ykcy
匏	pcds
酥	suyh
亮	llwj
酪	lcyk
慊	qpxn
矾	fjuf
族	zufu
绡	xnso
胜	ugou
周	vzkk
舅	jqjl
褴	ljpm
桀	jpxm
潺	ijdz
嫉	jinu
闱	wwmw
喧	xrkg
钠	najn
香	xlho
岭	lkes
黠	xxhk
沛	pwdl
痱	fwbf
氘	dcql
腈	jkoo
艄	ucvo
娓	wwnm
恪	kexk
墚	lltm
谢	xpyc
输	uuid
鼩	qujk
葳	wwcn
酵	jnyz
奕	yiwd
怊	icxk
刁	dnva
炬	juhj
苋	xmce
衡	hgii
钗	idji
图	tukd
会	hvrs
英	ykcy
缆	ljse
衅	xbxb
伍	wurw
党	dhxe
沾	vjdk
头	tzdd
翯	hexk
芑	qicj
机	jimj
狃	nqqi
芋	yucy
憩	qiqx
薇	wwcw
浴	yudk
由	yzla
饼	bkuk
诏	vcyk
庞	phgl
泓	hsds
约	ycsu
斜	xpru
忮	vixy
约	ytsu
坚	jmlt
舫	fhvf
帜	vijb
烺	lhhl
胂	ufou
诡	gvyv
补	bupb
辞	ciqu
选	xrze
锦	jbjj
橹	lumo
眠	mmom
钟	vsjv
帙	viju
涣	hrdd
编	bmsc
寄	jibk
府	fugc
接	jpfn
讲	jlyj
豢	hrju
耱	molu
羔	gcyh
蛱	jxij
跆	tdzk
枕	vfmv
硒	xiux
缙	jbso
鞨	hegv
袍	pcps
悔	hvxm
础	iuui
龆	tnvk
镪	qlji
砄	jtun
蓁	vfch
述	uuzu
殉	xydo
咏	ysky
愁	izhx
躐	lpzv
霆	tkyz
颜	yjir
驹	jumk
喘	irke
纵	zssr
蚯	qqiq
飨	xlxl
马	mava
芜	wucw
气	qipv
畴	iztc
嬉	xink
遢	tazx
深	ufdm
危	wwdv
撙	zyfc
狺	ybqk
据	jufk
丏	mmav
因	ybkd
琮	cswx
嫁	jxnu
延	yjzv
竟	jkle
罐	grff
蠹	duai
怼	dvyx
锱	zijt
兼	jmbn
役	yiiy
谈	tjyh
轼	uiig
执	vifw
芝	vicv
硁	kgug
纷	ffsd
秸	jphk
玄	xrwy
祛	qups
栟	bfmk
儇	xrry
砌	qiud
蛴	qiil
诫	jpyc
侈	iirx
伊	yiry
蝗	hliw
粑	bamb
避	bizu
沂	yidj
架	jxlm
萍	pkcp
俨	yjry
撵	nmfi
漏	lzdy
泄	xpdu
跗	fuzc
龅	bcvs
俜	pkrv
触	iudi
谎	hlyv
惦	dmxk
雒	lowf
谂	ufyx
较	jnix
笨	bfvb
布	buuj
牲	ugnu
龟	gvdv
锪	hojx
徉	yhiy
慵	ysxl
染	rjdm
蟀	ukiu
院	yree
语	yuyk
敷	fufw
嘞	lekl
萸	yucy
付	furc
徐	xuih
闯	ilmm
醇	iyyz
悖	bwxz
蕉	jnch
仄	zeir
柱	vumv
枸	gzmk
抻	iffu
蠡	livi
筑	vuvf
荬	mdcd
君	jyyk
污	wudk
佣	ysry
泠	lkds
多	doxx
惮	djxl
瑟	sewb
圣	ugyt
秕	bihb
靖	jklo
已	yivv
式	uiyg
铭	mkjk
伦	lyrb
镒	yijm
障	vheu
启	qihk
愎	bixw
博	bouc
插	iafj
杆	gjmg
桂	gvmt
疸	djbd
渠	qudm
配	pwyj
诎	quyi
隹	vvrf
厍	ueii
馨	xbuo
主	vudw
汋	qtdu
痢	libd
恤	xuxx
圯	yits
叩	kzke
站	vjlk
篙	gcvk
迹	jizd
镓	jxju
禹	yupd
熵	uhhk
耖	iclu
制	vipd
迟	iizi
焌	jyhw
钾	jxjj
秩	vihu
霪	ybyr
碌	lquu
蹅	iazd
潸	ujdo
玑	jiwj
遂	svzu
遇	yuzy
陨	yyer
搬	bjfy
棕	zsmx
厄	eeiv
咆	pcks
卷	jrjv
虑	lvhx
词	ciyk
霞	xxyy
皮	pivy
引	ybgl
萌	mgco
蝣	yziz
瘸	qtbr
贶	klke
耆	qilo
善	ujyk
珲	hvwi
讻	xsyk
晞	xioj
恹	yjxq
墒	uhtk
计	jiyu
拔	bafd
蔀	buce
侵	qbry
钺	ytjv
骊	liml
京	jkwx
盏	vjjm
渴	kedv
娴	xmnm
觫	sudu
碑	bwuu
遍	bmzc
炟	dahd
逵	kvzt
米	midm
蛹	ysiy
啧	zekr
河	hedk
唉	aiku
楹	ykmm
嬷	monm
邺	yeye
嘶	sikj
壮	vldu
羽	yuxx
璃	liwd
飏	yhjp
姑	gunk
脾	piou
夕	xipd
载	zdui
簕	levl
怵	iuxu
惆	izxk
详	xlyy
膝	xiou
莉	licd
凋	dndk
充	iswe
访	fhyf
谐	xpyb
加	jxlk
羚	lkys
骁	xnmw
奂	hrdd
要	ycxn
嘛	makm
汇	hvdk
碌	luuu
偬	zsrx
票	pnxx
坂	bjty
傍	bhrf
蘸	vjch
夭	ycpd
龄	lkvs
婿	xuno
蘑	mocu
护	hufh
底	digd
蜜	mibi
顽	wjer
轳	luiu
勠	luxl
佰	bdrb
戬	jmyg
咦	yiky
棋	qimb
婺	wusn
浅	qmdj
决	jtdg
瑶	ycwf
委	wwhn
煌	hlhw
麋	migm
冯	fgdm
逅	hzzk
煎	jmbh
归	gvle
窿	lsbu
洋	yhdy
徜	ihik
岂	qiej
焌	quhw
雄	xsuf
名	mkxk
驸	fumc
整	vguv
咚	dskd
过	gozc
挈	qpfu
赶	gjtg
捍	hjfg
椅	yimk
鱼	yuda
翊	yilx
锑	tijp
芙	fucf
褊	bmpc
秒	mnhu
屁	piub
司	sivk
愕	eexk
坑	kgtj
蔟	cucu
梧	wumk
屿	yuey
铝	lvjk
鞯	jmgz
庸	ysgl
斗	dzdu
比	bibb
听	tkkj
踔	iozu
穿	irby
癸	gvvt
咂	zakj
荔	licl
泡	pcds
宗	zsbx
庇	bigb
褡	dapk
钚	bujb
烩	hvhs
珲	hywi
疳	gjbg
扇	ujhx
翼	yixb
都	dzle
苜	muco
朵	dojm
诚	igyi
达	dazd
泸	ludu
粉	ffmd
害	hdbk
笕	jmve
葡	pucf
鳗	mjay
冢	vsbn
妃	fwnj
断	drmj
瘟	wfbm
骏	jymw
贻	yikk
壹	yiua
谅	llyx
呕	oukx
觎	yure
妒	dunh
姝	uunv
磬	qkuu
闪	ujmr
龙	lsud
妞	nqni
绝	jtsb
枯	kumk
辅	fuif
祐	yzpk
稍	ucho
完	wjbe
魈	xngo
爬	pavb
精	jkmo
勤	qbnl
蕾	lwct
壤	rhty
味	wwkw
戟	jiug
怡	yixk
锂	lijl
件	jmrn
硫	lquv
茫	mhcw
虱	uivi
钒	fjjf
议	yiyy
诌	vzye
骅	hxmu
枋	fhmf
街	jpii
袜	wapm
坦	tjtd
枭	xnpm
嵚	qber
般	bjvy
烨	yehu
蜂	fgif
璩	quwu
豹	bcvu
枚	mwmw
遽	juzu
鱽	dcad
铷	rujk
埯	antd
固	gukk
燧	svhz
筝	vgvl
惮	daxl
窟	kubi
记	jiyj
醵	juyu
依	yiry
颓	tvhr
炘	xbhj
鄢	yjve
冰	bkdu
嗜	uiko
疗	lnbl
喇	lakd
稼	jxhu
瘊	hzbu
熨	yyuh
副	fuad
辑	jiie
初	iupd
硝	xnuo
媒	mwnm
佺	qrrw
迭	dpzu
煅	drhy
羰	thyh
醍	tiyr
阼	zoev
凰	hljw
格	gemk
涤	didm
淞	ssds
注	vudv
礁	jnuh
汀	tkdd
坽	lkts
州	vzdl
啤	piku
监	jmlm
鹦	ykkn
灼	vohu
荆	jkcd
历	liil
吩	ffkd
啬	seuk
毙	bibb
屹	yieq
谛	diyj
垆	lutu
湛	vjdv
等	dgvc
巾	jbll
顶	dkdr
瞳	tsol
硖	xxuj
沅	yrde
郯	tjhe
砾	liul
呀	yaky
汁	vidu
沭	uudu
爆	bchu
黍	uuhu
巍	wweg
烦	fjhr
法	fads
误	wuyt
怅	ihxi
巯	qqvv
杏	xkmk
谨	jbya
厮	siij
科	kehu
帘	lmbj
赂	lukk
踯	vize
蜉	fuiz
研	yjuk
翠	cvxu
焦	jnrh
绅	ufsu
屈	quui
沪	hudh
溻	tadx
龚	gslb
窄	vdbv
物	wunw
岘	xmee
檐	yjmk
心	xbdd
铜	tsjk
镏	lqjt
扶	fuff
欺	qiqr
汾	ffdd
滨	bbdb
牢	lcbn
迳	jkzg
晶	jkoo
洴	pkdk
随	svez
祠	cipk
家	jxbu
将	jldc
椭	tomo
莨	lhcl
磙	gyuy
外	wdxb
伸	ufru
使	uirl
榭	xpmc
拒	jufj
忭	bmxb
预	yusr
飕	szjy
例	lird
斛	hudu
坷	ketk
哺	bukf
间	jmmo
铰	jnjx
肝	gjog
摇	ycff
刻	kewd
吗	makm
柄	bkmb
辨	bmlu
部	bule
弥	migx
令	lkrs
赢	ykwf
戒	jpgc
呤	lkks
惑	hogx
禺	yuld
距	juzj
桐	tsmk
舂	isfj
胆	djod
拳	qrju
骡	lomx
衔	xmii
荫	ybco
棒	bhml
尻	kcuj
每	mwpm
离	liwd
竑	hsls
贩	fjky
恬	tmxk
谖	xryy
膺	ykgo
龟	qqdv
畏	wwtn
鸳	yrxn
碧	biwu
啖	djkh
寞	mobd
讣	fuyb
欢	hryr
谄	ijyj
钰	yujy
浠	xidj
字	zibz
龟	jydv
渍	zidr
悼	dcxu
玖	jqwj
练	lmsd
楞	lgmf
稀	xihj
罅	xxfh
汞	gsgu
级	jisj
嬴	ykwf
雪	xtye
馐	xqui
砄	jtug
芦	luch
橘	jumk
梓	zimu
淡	djdh
逦	lizl
熄	xihx
刃	rfdd
衍	yjii
超	ictk
黉	hsxb
稗	bdhu
驱	qumx
棵	kemg
界	jptl
移	yihx
瞠	igot
览	ljle
事	uial
锉	cojt
渲	xrdg
哀	aiwy
梁	lldm
荇	xkci
狭	xxqj
即	jige
汆	crru
耜	silk
馘	goba
瑔	qrwu
虎	huhj
梵	fjmf
瓣	bjlu
缘	yrsu
藓	xmcy
琰	yjwh
靼	dagd
畚	bfst
肪	fhof
铧	hxju
瞵	lbol
循	xyio
虢	gopj
悢	llxl
锶	sijx
局	juuk
弗	fuvl
实	uibd
性	xkxu
槌	ivmz
材	cdmc
砗	ieui
仓	chrv
迅	xyzu
萃	cvcu
滑	hxdg
沙	uadu
蓟	jicd
蟑	vhiu
喜	xiuk
酮	tsyk
璧	biuy
少	ucxp
衠	vyii
疚	jqbj
蚬	xmie
鹂	liln
锅	gojn
悌	tixp
黔	qmhv
阔	komk
苍	chcv
荚	jxcj
皇	hlbw
冼	xmde
俳	pdrf
蕻	hscb
煸	bmhc
谭	tjyu
原	yrix
林	lbmm
柬	jman
蟹	xpdi
鞑	dagz
栋	dsmd
箫	xnvs
昨	zoov
杨	yhmp
恍	hlxw
划	hxgd
哂	ufkx
哒	dakz
稽	jiho
霉	mwym
冤	yrbd
妨	fhnf
星	xkou
毅	yily
渚	vudo
玉	yuwd
韪	wwow
问	wfmk
知	viuk
谝	pmyc
颖	ykbr
魉	llgl
齿	iivk
剐	gxkd
彝	yivc
假	jxry
祈	qipj
零	lkys
冀	jilb
列	lpdd
都	dule
莨	llcl
槁	gcmk
漾	yhdy
减	jmdk
沔	mmdm
为	wwdd
找	vcfg
碎	svuu
胃	wwto
诳	klyw
嚏	tikr
躬	gsug
轩	xrig
颙	ysyr
肩	jmho
文	wfwx
锯	jujk
鱿	yzay
代	ddry
迦	jxzk
澎	pgdp
鞭	bmgg
蛆	quiq
阪	bjey
圾	jitj
淹	yjdd
俾	biru
抄	icfu
碗	wjuv
冯	pkdm
碳	tjuh
谑	xtya
卢	lulu
咒	vzkj
炸	vahv
瓶	pkbw
池	iidy
咫	viib
貌	mcve
贪	tjrr
途	tuzh
樊	fjmd
锌	xbju
鼓	guuy
望	whww
笊	vcvv
辛	xblu
涑	sudu
爸	babb
炒	ichu
诂	guyk
慊	qmxn
匡	klkw
拿	naru
殆	dddk
劲	jbvl
扁	bmhc
冷	lgds
娇	jnnl
栗	lixm
惊	jkxx
津	jbdy
炯	jshk
猗	yiqk
撤	iefw
濠	hcdu
瘴	vhbu
匪	fwkf
烁	uohl
绶	uzsy
舐	uiqu
醒	xkyu
挨	aifu
骸	hdgr
嫔	pbnb
溢	yidm
螃	phif
魅	mwgw
黩	duhd
涛	tcdc
宇	yuby
粱	lldm
镲	iajx
酝	yyys
农	nsdn
筻	ghvg
辚	lbil
郁	yuue
澡	zcdm
霹	piyu
馗	kvjz
黥	qkhx
蜍	iuih
蜾	goig
尽	jbid
连	lmzi
钋	pojb
觊	jiee
讶	yayy
迕	wuzw
痒	yhby
官	grbk
闭	bimc
燕	yjnh
痧	uabu
箔	bovb
岙	aoye
飓	jujb
奚	xipd
钍	tujt
厘	liil
株	vumv
跪	gvzv
端	drle
档	dhme
粕	pomb
竭	jplv
郫	pipe
瑗	yrwy
任	rfrr
殇	uhdp
席	xigj
户	hudu
钢	ghjx
曰	ytka
洛	lodk
缯	zgso
溅	jmdj
筛	udvj
蕲	qicj
庚	gggn
枷	jxmk
切	qpqd
揪	jqfh
狱	yuqq
贡	gsgr
僻	piru
免	mmdv
同	tskk
唪	fgkl
喳	vakd
富	fubt
崡	hjek
拯	vgfa
媳	xinx
眺	tnod
翕	xirx
趵	bczu
项	xlgr
癯	qubf
嵊	ugen
蜕	tvie
鹬	yusn
兢	jkue
匈	xsbk
腆	tmob
认	rfyr
诞	djyz
笈	jivj
奏	zzft
溞	scdi
沔	mmdv
吧	bakb
径	jkig
瘩	dabk
耳	eraa
书	uuvd
盘	pjvm
翻	fjpx
枳	vimb
耗	hclm
胡	huuo
谜	miyz
驼	tomb
数	uumw
唧	jike
市	uiwj
诐	biyy
敢	gjvw
蚓	ybil
钻	zrjk
骝	lqmt
姆	munm
铵	anjn
柒	qidm
蚩	iivi
圬	wutk
订	dkyd
鹨	lqxn
晚	wjov
镖	bnjx
究	jqbj
旨	vibo
急	jidx
报	bcfy
鼹	yjjn
驯	xymi
榧	fwmf
氚	irqi
航	hhvj
氐	diud
幔	mjjy
蛛	vuiv
候	hzru
鄑	ziye
叫	jnkl
喳	iakd
讼	ssys
趟	thtk
总	zsbx
熨	yuuh
醺	xyyh
糅	rzmm
舢	ujve
涂	tudh
巫	wugr
甚	ufqv
舌	ueqk
左	zoug
数	uomw
殿	dmuy
稳	wfhx
圄	yukk
标	bnmx
俚	lirl
铂	bojb
咡	erke
庋	gvgy
土	tuua
浃	jxdj
漓	lidd
碴	iaud
憭	lnxx
鬣	lpav
劲	jkvl
治	vidk
益	yibm
贞	vflr
荷	heck
璋	vhwu
妗	jbnv
庙	mngy
砭	bmuf
远	yrze
氧	yhqy
徊	hkik
旬	xybo
亦	yiwd
己	jivv
炌	kdhl
夤	ybxb
聋	lsle
谷	gubk
逐	vuzu
榨	vamv
智	viuo
匀	yybd
桦	hxmu
涸	hedk
把	bafb
咧	lpkd
砷	ufuu
诬	wuyr
诃	heyk
起	qitj
枸	jumk
及	jipn
扁	pmhc
秽	hvhx
铀	yzjy
中	vsll
赋	fukv
驶	uimu
继	jisv
砆	fuuf
钴	gujk
镞	zuju
窍	qnbv
利	lihd
垲	kdtj
班	bjww
未	wwan
严	yjyp
倏	uurq
抖	dzfu
骑	qimk
泳	ysdy
赤	iitd
沽	gudk
漆	qidu
缦	mjsy
玫	mwww
喾	kuxk
勍	qkwl
泉	qrbu
猩	xkqu
蒴	uoco
贰	eryr
烟	yjhd
婊	bnny
演	yjdb
纫	rfsr
讨	tcyc
镇	vfjb
嘞	lwkl
恸	tsxl
殓	lmda
铅	qmjk
鬻	yugl
伟	wwrw
凶	xsxk
娘	nlnl
惧	juxb
械	xpmc
愐	mmxm
尢	yzuv
吨	dykt
